
F 0,255,0
C 255,0,0




NO ./textures/xpm/eagle.xpm
SO ./textures/xpm/redbrick.xpm
WE ./textures/xpm/purplestone.xpm
EA ./textures/xpm/greystone.xpm













         11111111111111111111111
         100000000110000000000001
         11000001110000000000001
         11000000000000000000001
111111111111000001110000000000001
100000000111000001110111111111111
11110110011111011100000010001
11110110011111011101010010001
11000000010101011100000010001
10000000010000001100000010001
10000000010000001101010010001
11000001110101011111011110E001
11110111 1110101 101111010001
11111111 1111111 111111111111





























