F 50,46,46
C 76,12,104




NO ./textures/xpm/tech1.xpm
SO ./textures/xpm/tech2.xpm
WE ./textures/xpm/tech3.xpm
EA ./textures/xpm/tech4.xpm













         11111111111111111111111
         100000000110001000000001
         11000001110000100000001
         11000000000000000000001
111111111111000001110000000000001
100000000111000001110111111011111
11110110011111011100000010001
11110110011111011101010010001
11000000010101011100000100S001
10000000010000001100000010001
10000000010000001101010010001
110000011101010111110111110001
11110111 1110101 101111010101
11111111 1111111 111111111111





























